N_WORKERS,COMM_PERIOD,AGG_MODE,COMM_MODE,NONIID,UNBALANCED,TIME,ACCURACY,PKT_SIZE
16,1,0,0,0,0,60.652477,82.3300,44.968
16,1,0,0,0,1,72.326389,82.3600,44.968
16,1,0,0,1,0,61.542717,77.6200,44.968
16,1,0,0,1,1,56.026156,64.1800,44.968
16,1,0,1,0,0,54.166555,82.1800,23.353
16,1,0,1,0,1,61.465185,82.8300,28.270
16,1,0,1,1,0,49.283331,73.8400,24.223
16,1,0,1,1,1,54.785210,63.5200,23.803
16,1,0,2,0,0,57.010613,81.9800,5.336
16,1,0,2,0,1,48.178866,81.0800,5.756
16,1,0,2,1,0,50.315905,46.0500,5.456
16,1,0,2,1,0,,,
16,1,0,2,1,1,54.463398,50.1200,5.816
16,1,1,0,0,0,53.082782,82.3300,44.968
16,1,1,0,0,1,74.097981,82.3600,44.968
16,1,1,0,1,0,59.055749,77.6200,44.968
16,1,1,0,1,1,55.599540,64.1800,44.968
16,1,1,1,0,0,51.162418,82.1100,23.353
16,1,1,1,0,1,64.204691,82.8400,28.270
16,1,1,1,1,0,51.455582,68.2900,24.223
16,1,1,1,1,1,59.154113,64.4200,23.803
16,1,1,2,0,0,51.295309,81.9800,5.336
16,1,1,2,0,1,52.238587,81.0800,5.756
16,1,1,2,1,0,51.350020,46.0500,5.456
16,1,1,2,1,0,53.231036,46.0500,5.456
16,1,1,2,1,1,57.925528,50.1200,5.816
16,10,0,0,0,0,41.088642,82.3200,4.497
16,10,0,0,0,1,51.957779,82.3800,4.497
16,10,0,0,1,0,39.429843,57.5100,4.497
16,10,0,0,1,1,38.199650,43.8200,4.497
16,10,1,0,0,0,40.937495,82.3200,4.497
16,10,1,0,0,1,37.839352,82.3800,4.497
16,10,1,0,1,0,40.042556,57.5100,4.497
16,10,1,0,1,1,42.078619,43.8200,4.497
16,20,0,0,0,0,39.522825,82.3000,2.248
16,20,0,0,0,1,39.990605,82.2900,2.248
16,20,0,0,1,0,39.948314,46.4800,2.248
16,20,0,0,1,1,36.860973,39.7300,2.248
16,20,1,0,0,0,40.297121,82.3000,2.248
16,20,1,0,0,1,46.045176,82.2900,2.248
16,20,1,0,1,0,39.036174,46.4800,2.248
16,20,1,0,1,1,35.859849,39.7300,2.248
16,50,0,0,0,0,39.101447,82.2600,0.899
16,50,0,0,0,1,35.899642,82.1100,0.899
16,50,0,0,1,0,39.230509,37.3800,0.899
16,50,0,0,1,1,36.606815,26.2400,0.899
16,50,1,0,0,0,39.178140,82.2600,0.899
16,50,1,0,0,1,46.720171,82.1100,0.899
16,50,1,0,1,0,39.271614,37.3800,0.899
16,50,1,0,1,1,41.832592,26.2400,0.899
16,100,0,0,0,0,38.318093,82.2700,0.450
16,100,0,0,0,1,35.496051,81.7900,0.450
16,100,0,0,1,0,38.637348,32.9900,0.450
16,100,0,0,1,1,39.691589,23.0000,0.450
16,100,1,0,0,0,38.356057,82.2700,0.450
16,100,1,0,0,1,42.392884,81.7900,0.450
16,100,1,0,1,0,39.052783,32.9900,0.450
16,100,1,0,1,1,37.741383,23.0000,0.450
32,1,0,0,0,0,37.728414,80.9500,92.934
32,1,0,0,0,1,55.826863,80.9500,92.934
32,1,0,0,1,0,49.984650,77.6700,92.934
32,1,0,0,1,1,59.979025,64.3500,92.934
32,1,0,1,0,0,39.639169,80.7700,40.231
32,1,0,1,0,1,42.403844,81.6600,55.071
32,1,0,1,1,0,34.525957,71.9600,48.236
32,1,0,1,1,1,43.804799,62.8300,49.765
32,1,0,2,0,0,41.755225,80.7200,10.043
32,1,0,2,0,1,37.151412,80.5800,10.403
32,1,0,2,1,0,36.100611,54.5500,8.934
32,1,0,2,1,1,39.813447,59.2400,9.563
32,1,1,0,0,0,38.489606,80.9500,92.934
32,1,1,0,0,1,59.431855,80.9500,92.934
32,1,1,0,1,0,37.639466,77.6700,92.934
32,1,1,0,1,1,50.707368,64.3500,92.934
32,1,1,1,0,0,41.562262,80.6900,40.231
32,1,1,1,0,1,46.946655,81.6700,55.071
32,1,1,1,1,0,38.846707,72.1100,48.236
32,1,1,1,1,1,41.032156,61.1900,49.765
32,1,1,2,0,0,39.060068,80.7200,10.043
32,1,1,2,0,1,42.179990,80.5800,10.403
32,1,1,2,1,0,42.370467,54.5500,8.934
32,1,1,2,1,1,36.464281,59.2400,9.563
32,10,0,0,0,0,27.920768,80.9400,9.293
32,10,0,0,0,1,25.611665,80.9600,9.293
32,10,0,0,1,0,26.119560,58.8600,9.293
32,10,0,0,1,1,26.079559,40.3300,9.293
32,10,1,0,0,0,26.693646,80.9400,9.293
32,10,1,0,0,1,27.506687,80.9600,9.293
32,10,1,0,1,0,28.090327,58.8600,9.293
32,10,1,0,1,1,37.935009,40.3300,9.293
32,20,0,0,0,0,25.215169,80.9300,4.647
32,20,0,0,0,1,26.836036,80.9400,4.647
32,20,0,0,1,0,24.524915,47.4700,4.647
32,20,0,0,1,1,26.333798,35.1600,4.647
32,20,1,0,0,0,23.979646,80.9300,4.647
32,20,1,0,0,1,26.478805,80.9400,4.647
32,20,1,0,1,0,25.139071,47.4700,4.647
32,20,1,0,1,1,25.403876,35.1600,4.647
32,50,0,0,0,0,23.483322,80.8900,1.859
32,50,0,0,0,1,24.038413,80.8000,1.859
32,50,0,0,1,0,23.187346,38.0200,1.859
32,50,0,0,1,1,28.138650,30.6700,1.859
32,50,1,0,0,0,23.163294,80.8900,1.859
32,50,1,0,0,1,27.596854,80.8000,1.859
32,50,1,0,1,0,24.147564,38.0200,1.859
32,50,1,0,1,1,24.520103,30.6700,1.859
32,100,0,0,0,0,23.826315,80.8700,0.929
32,100,0,0,0,1,21.132019,80.3200,0.929
32,100,0,0,1,0,24.070569,32.9000,0.929
32,100,0,0,1,1,25.987236,22.3000,0.929
32,100,1,0,0,0,22.724875,80.8700,0.929
32,100,1,0,0,1,25.413807,80.3200,0.929
32,100,1,0,1,0,23.042122,32.9000,0.929
32,100,1,0,1,1,27.901138,22.3000,0.929
64,1,0,0,0,0,37.316292,79.1600,188.866
64,1,0,0,0,1,48.908064,79.3700,188.866
64,1,0,0,1,0,39.949200,76.6900,188.866
64,1,0,0,1,1,50.989075,71.5200,188.866
64,1,0,1,0,0,35.709331,78.8500,95.872
64,1,0,1,0,1,44.801924,80.5000,99.080
64,1,0,1,1,0,34.058673,64.7900,95.302
64,1,0,1,1,1,38.884086,69.0200,87.658
64,1,0,2,0,0,43.605770,79.2000,26.381
64,1,0,2,0,1,36.126118,78.6500,26.411
64,1,0,2,1,0,36.569513,63.5700,17.747
64,1,0,2,1,1,33.503126,61.9600,22.814
64,1,1,0,0,0,38.222111,79.1600,188.866
64,1,1,0,0,1,49.497367,79.3700,188.866
64,1,1,0,1,0,38.670038,76.6900,188.866
64,1,1,0,1,1,48.709202,71.5200,188.866
64,1,1,1,0,0,33.519644,78.8500,95.872
64,1,1,1,0,1,42.190504,80.4400,99.080
64,1,1,1,1,0,34.159706,68.1800,95.302
64,1,1,1,1,1,34.585355,67.8800,87.658
64,1,1,2,0,0,39.421713,79.2000,26.381
64,1,1,2,0,1,41.841849,78.6500,26.411
64,1,1,2,1,0,30.910865,63.5700,17.747
64,1,1,2,1,1,35.828036,61.9600,22.814
8,1,0,0,0,0,81.296358,83.3000,20.985
8,1,0,0,0,1,82.823867,83.3100,20.985
8,1,0,0,1,0,81.528906,72.8800,20.985
8,1,0,0,1,1,83.215177,67.7900,20.985
8,1,0,1,0,0,81.191348,83.2900,13.520
8,1,0,1,0,1,80.321041,83.4400,14.060
8,1,0,1,1,0,79.825170,60.8000,10.163
8,1,0,1,1,1,80.118829,69.2300,12.741
8,1,0,2,0,0,81.973686,83.0400,3.897
8,1,0,2,0,1,80.098669,83.6000,3.867
8,1,0,2,1,0,,23.3300,
8,1,0,2,1,0,80.499516,33.8200,3.747
8,1,0,2,1,1,78.284072,43.8600,3.837
8,1,1,0,0,0,81.111124,83.3000,20.985
8,1,1,0,0,1,84.121199,83.3100,20.985
8,1,1,0,1,0,81.112233,72.8800,20.985
8,1,1,0,1,1,83.298596,67.7900,20.985
8,1,1,1,0,0,81.325586,83.1100,13.520
8,1,1,1,0,1,78.973186,83.4100,14.060
8,1,1,1,1,0,79.875899,60.8700,10.163
8,1,1,1,1,1,81.037678,69.3500,12.741
8,1,1,2,0,0,81.135974,83.0400,3.897
8,1,1,2,0,1,79.630816,83.6000,3.867
8,1,1,2,1,0,81.935009,33.8200,3.747
8,1,1,2,1,0,,23.3300,
8,1,1,2,1,1,79.068699,43.8600,3.837
8,10,0,0,0,0,68.282716,83.3000,2.099
8,10,0,0,0,1,64.872419,83.2800,2.099
8,10,0,0,1,0,68.519157,52.7500,2.099
8,10,0,0,1,1,65.865645,55.0800,2.099
8,10,1,0,0,0,67.744885,83.3000,2.099
8,10,1,0,0,1,65.448938,83.2800,2.099
8,10,1,0,1,0,67.134549,52.7500,2.099
8,10,1,0,1,1,65.759144,55.0800,2.099
8,20,0,0,0,0,66.911958,83.2800,1.049
8,20,0,0,0,1,63.879532,83.2100,1.049
8,20,0,0,1,0,68.188359,48.4800,1.049
8,20,0,0,1,1,64.575735,44.8100,1.049
8,20,1,0,0,0,67.732052,83.2800,1.049
8,20,1,0,0,1,65.103688,83.2100,1.049
8,20,1,0,1,0,66.715260,48.4800,1.049
8,20,1,0,1,1,64.786448,44.8100,1.049
8,50,0,0,0,0,66.954388,83.2600,0.420
8,50,0,0,0,1,65.840092,83.1100,0.420
8,50,0,0,1,0,66.602004,45.9500,0.420
8,50,0,0,1,1,64.311440,29.6100,0.420
8,50,1,0,0,0,66.954560,83.2600,0.420
8,50,1,0,0,1,63.690424,83.1100,0.420
8,50,1,0,1,0,67.540859,45.9500,0.420
8,50,1,0,1,1,63.758009,29.6100,0.420
8,100,0,0,0,0,66.328972,83.2000,0.210
8,100,0,0,0,1,65.227352,83.0300,0.210
8,100,0,0,1,0,66.373390,43.1500,0.210
8,100,0,0,1,1,63.537794,25.0600,0.210
8,100,1,0,0,0,66.059596,83.2000,0.210
8,100,1,0,0,1,63.281691,83.0300,0.210
8,100,1,0,1,0,66.455516,43.1500,0.210
8,100,1,0,1,1,63.779532,25.0600,0.210
