N_WORKERS,COMM_PERIOD,OVERLAP,COMM_MODE,AGG_MODE,NONIID,UNBALANCED,TIME,ACCURACY
128,1,0.0,0,0,0,0,46.962904,87.0500
128,1,0.0,0,0,0,1,49.405476,87.1200
128,1,0.0,0,0,1,0,47.189411,86.9000
128,1,0.0,0,0,1,1,48.217714,85.7800
128,1,0.0,0,2,0,0,49.194191,87.0500
128,1,0.0,0,2,0,1,46.664180,87.1200
128,1,0.0,0,2,1,0,49.817912,87.0100
128,1,0.0,0,2,1,1,50.305207,85.7200
128,1,0.0,0,3,0,0,49.960676,84.4600
128,1,0.0,0,3,0,1,40.058042,89.4500
128,1,0.0,0,3,1,0,49.620304,19.0700
128,1,0.0,0,3,1,1,52.136446,19.7600
128,1,0.0,1,0,0,0,40.190906,86.7600
128,1,0.0,1,0,0,1,47.583920,88.3700
128,1,0.0,1,0,1,0,37.930603,84.0900
128,1,0.0,1,0,1,1,37.911583,85.6100
128,1,0.0,1,2,0,0,36.703425,86.7700
128,1,0.0,1,2,0,1,40.502376,88.3800
128,1,0.0,1,2,1,0,37.206544,84.3700
128,1,0.0,1,2,1,1,40.597429,85.6700
128,1,0.0,1,3,0,0,36.166046,84.1400
128,1,0.0,1,3,0,1,43.514342,89.2300
128,1,0.0,1,3,1,0,,
128,1,0.0,1,3,1,1,37.623854,19.8200
128,1,0.0,2,0,0,0,43.890419,86.9500
128,1,0.0,2,0,0,1,,
128,1,0.0,2,0,1,0,38.332059,87.0000
128,1,0.0,2,0,1,1,35.585942,84.9500
128,1,0.0,2,2,0,0,40.028122,86.9800
128,1,0.0,2,2,0,1,,
128,1,0.0,2,2,1,0,38.863762,86.7900
128,1,0.0,2,2,1,1,,
128,1,0.0,2,3,0,0,40.845678,86.2800
128,1,0.0,2,3,0,1,,
128,1,0.0,2,3,1,0,38.435762,43.9800
128,1,0.0,2,3,1,1,,
32,1,0.0,0,0,0,0,38.725822,89.5800
32,1,0.0,0,0,0,1,53.276764,89.5700
32,1,0.0,0,0,1,0,44.878218,88.4100
32,1,0.0,0,0,1,1,64.437718,84.9800
32,1,0.0,0,2,0,0,41.194082,89.5800
32,1,0.0,0,2,0,1,44.019518,89.5600
32,1,0.0,0,2,1,0,37.516938,88.4200
32,1,0.0,0,2,1,1,66.200025,84.8900
32,1,0.0,0,3,0,0,50.244431,89.1500
32,1,0.0,0,3,0,1,52.526531,90.2400
32,1,0.0,0,3,1,0,48.628600,19.7200
32,1,0.0,0,3,1,1,58.398678,26.0800
32,1,0.0,1,0,0,0,40.116041,89.5000
32,1,0.0,1,0,0,1,49.152049,90.0100
32,1,0.0,1,0,1,0,41.353070,87.0900
32,1,0.0,1,0,1,1,53.967514,85.2900
32,1,0.0,1,2,0,0,38.672567,89.4600
32,1,0.0,1,2,0,1,42.376728,90.0200
32,1,0.0,1,2,1,0,38.448068,86.5000
32,1,0.0,1,2,1,1,42.777518,86.1800
32,1,0.0,1,3,0,0,41.656275,88.9100
32,1,0.0,1,3,0,1,42.652670,89.9800
32,1,0.0,1,3,1,0,46.610744,28.6100
32,1,0.0,1,3,1,1,45.980284,35.3500
32,1,0.0,2,0,0,0,,
32,1,0.0,2,0,0,1,42.268392,89.8400
32,1,0.0,2,0,1,0,,
32,1,0.0,2,0,1,1,,
32,1,0.0,2,2,0,0,40.201955,89.5100
32,1,0.0,2,2,0,1,,
32,1,0.0,2,2,1,0,38.069741,88.4100
32,1,0.0,2,2,1,1,,
32,1,0.0,2,3,0,0,,
32,1,0.0,2,3,0,1,,
32,1,0.0,2,3,1,0,,
32,1,0.0,2,3,1,1,,
64,1,0.0,0,0,0,0,34.593874,88.4400
64,1,0.0,0,0,0,1,49.526083,88.6100
64,1,0.0,0,0,1,0,36.154520,87.7300
64,1,0.0,0,0,1,1,44.186561,87.3900
64,1,0.0,0,2,0,0,38.627704,88.4200
64,1,0.0,0,2,0,1,44.663810,88.6200
64,1,0.0,0,2,1,0,37.667752,87.7400
64,1,0.0,0,2,1,1,48.304776,87.4900
64,1,0.0,0,3,0,0,42.685004,88.2100
64,1,0.0,0,3,0,1,42.889899,89.4800
64,1,0.0,0,3,1,0,40.922638,19.8500
64,1,0.0,0,3,1,1,51.997756,19.7600
64,1,0.0,1,0,0,0,39.217652,88.2700
64,1,0.0,1,0,0,1,39.218526,88.9700
64,1,0.0,1,0,1,0,39.676203,86.1200
64,1,0.0,1,0,1,1,37.866417,86.9300
64,1,0.0,1,2,0,0,31.959041,88.2500
64,1,0.0,1,2,0,1,41.999761,88.9900
64,1,0.0,1,2,1,0,31.473764,86.1800
64,1,0.0,1,2,1,1,42.121617,87.0700
64,1,0.0,1,3,0,0,34.656194,87.9400
64,1,0.0,1,3,0,1,40.998031,89.1800
64,1,0.0,1,3,1,0,34.181200,19.8400
64,1,0.0,1,3,1,1,47.853841,27.5600
64,1,0.0,2,0,0,0,39.867969,88.2900
64,1,0.0,2,0,0,1,,
64,1,0.0,2,0,1,0,,
64,1,0.0,2,0,1,1,,
64,1,0.0,2,2,0,0,33.554338,88.3300
64,1,0.0,2,2,0,1,33.151042,88.4900
64,1,0.0,2,2,1,0,,
64,1,0.0,2,2,1,1,,
64,1,0.0,2,3,0,0,47.741524,88.3600
64,1,0.0,2,3,0,1,,
64,1,0.0,2,3,1,0,,
64,1,0.0,2,3,1,1,,
8,1,0.0,0,0,0,0,80.284260,91.2600
8,1,0.0,0,0,0,1,82.993293,91.2500
8,1,0.0,0,0,1,0,81.635720,88.8900
8,1,0.0,0,0,1,1,81.594314,82.5300
8,1,0.0,0,2,0,0,81.881099,91.2600
8,1,0.0,0,2,0,1,82.874970,91.2500
8,1,0.0,0,2,1,0,81.459455,88.8900
8,1,0.0,0,2,1,1,82.487672,82.6200
8,1,0.0,0,3,0,0,87.295892,91.0400
8,1,0.0,0,3,0,1,89.325376,91.5700
8,1,0.0,0,3,1,0,87.826508,27.7900
8,1,0.0,0,3,1,1,87.106873,37.5900
8,1,0.0,1,0,0,0,86.583690,90.9900
8,1,0.0,1,0,0,1,87.221869,91.4400
8,1,0.0,1,0,1,0,86.882209,71.9100
8,1,0.0,1,0,1,1,86.170521,83.3300
8,1,0.0,1,2,0,0,87.658831,91.0200
8,1,0.0,1,2,0,1,86.257621,91.4400
8,1,0.0,1,2,1,0,86.744400,72.0700
8,1,0.0,1,2,1,1,84.261614,83.3600
8,1,0.0,1,3,0,0,86.357592,90.7200
8,1,0.0,1,3,0,1,87.441407,91.5500
8,1,0.0,1,3,1,0,86.428161,27.8300
8,1,0.0,1,3,1,1,84.891320,37.6000
8,1,0.0,2,0,0,0,83.095519,91.1800
8,1,0.0,2,0,0,1,79.351706,91.2100
8,1,0.0,2,0,1,0,,
8,1,0.0,2,0,1,1,,
8,1,0.0,2,2,0,0,83.030932,91.2000
8,1,0.0,2,2,0,1,81.555400,91.2300
8,1,0.0,2,2,1,0,81.845792,87.1500
8,1,0.0,2,2,1,1,,
8,1,0.0,2,3,0,0,89.080205,91.0500
8,1,0.0,2,3,0,1,,
8,1,0.0,2,3,1,0,,
8,1,0.0,2,3,1,1,,
